List of which Digimon swapped with which Pokemon

Argomon - Bulbasaur
Bombmon - Ivysaur
Bommon - Venusaur
Botamon - Charmander
Chibickmon - Charmeleon
Chibomon - Charizard
Conomon - Squirtle
Cotsucomon - Wartortle
Curimon - Blastoise
Datirimon - Caterpie
Dodomon - Metapod
Dokimon - Butterfree
Fufumon - Weedle
Jyarimon - Kakuna
Keemon - Beedrill
Ketomon - Pidgey
Kuramon - Pidgeotto
Leafmon - Pidgeot
Choromon - Rattata
Mokumon - Raticate
Nyokimon - Spearow
Pabumon - Fearow
Pafumon - Ekans
Paomon - Arbok
Petitmon - Pikachu
Pichimon - Raichu
Popomon - Sandshrew
Poyomon - Sandslash
Punimon - Nidoran(F)
Pupumon - Nidorina
Pururumon - Nidoqueen
Pusumon - Nidoran(M)
Puttimon - Nidorino
Puwamon - Nidoking
Puyomon - Clefairy
Pyonmon - Clefable
Relemon - Vulpix
Sakumon - Ninetales
Sandmon - Jigglypuff
Tsubumon - Wigglytuff
IceBotamon - Zubat
Yuramon - Golbat
Zerimon - Oddish
Zurumon - Gloom